1 1 2 2 2 2 1 1 0 0 1 4 4 4 2 2 2 2 2 2 4 4 4 4 2 2 2 4 4 4 4 1 0 1 2 2 2 2 2 4 4 4 2 1 0 1 1 2 2 2 2 2 2 2 2 2 2 2 4 4 4 2 2 2 2 2 2 2 2 2 2 2 2 2 2 2 2 2 2 2 2 2 2 2 2 2 2 2 2 2 2 2 2 2 2 2 4 4 4 1
1 2 2 2 2 2 1 0 0 0 1 4 4 4 2 2 2 2 2 2 4 4 4 4 2 2 2 4 4 4 4 1 0 0 2 2 2 2 2 4 4 4 2 1 1 4 4 2 2 2 2 2 2 2 2 2 2 2 4 4 4 4 2 2 4 4 4 2 2 1 2 2 2 2 2 2 2 2 2 2 2 2 2 2 2 2 2 2 2 2 2 2 2 2 2 2 4 4 4 2
2 2 2 2 2 2 2 1 0 0 1 4 4 4 2 2 2 2 2 2 4 4 4 4 4 2 2 4 4 4 4 1 0 0 1 1 2 2 2 4 4 4 4 4 4 4 4 2 2 2 2 2 2 2 2 2 2 2 4 4 4 4 4 2 4 4 4 2 2 1 1 2 2 2 2 2 2 2 2 2 2 2 2 2 2 2 2 4 4 4 2 2 2 4 4 4 4 4 4 2
2 2 2 2 2 2 2 2 2 1 2 2 4 2 2 2 2 2 2 2 2 4 4 4 4 2 2 2 4 2 4 2 1 4 4 1 2 2 2 2 4 2 4 4 4 4 4 2 2 2 2 2 2 2 2 1 1 2 2 4 4 4 4 2 4 4 4 2 2 1 1 2 2 4 4 4 2 2 2 2 2 2 2 2 2 2 2 4 4 4 2 2 2 4 4 4 2 4 2 2
2 2 2 2 2 2 2 2 2 2 2 2 2 2 2 2 2 2 2 2 4 4 4 4 4 2 2 2 2 2 2 2 4 4 1 2 2 2 1 1 2 2 4 4 4 4 2 2 2 2 2 2 2 2 1 0 0 0 1 2 4 4 4 2 2 4 2 2 2 2 1 2 2 4 4 4 2 2 2 2 2 2 2 2 2 2 2 4 4 4 2 2 2 4 4 4 2 2 2 2
1 1 1 2 2 2 2 2 2 2 2 2 2 2 2 2 2 2 2 2 4 4 4 4 2 2 2 2 1 2 2 2 4 4 4 2 2 2 1 0 1 1 2 4 4 4 2 2 2 2 2 2 2 2 2 0 0 0 1 2 2 4 2 1 1 2 2 2 2 2 2 2 2 4 4 4 2 2 2 4 4 4 2 2 4 4 4 1 4 2 2 1 1 1 4 2 2 2 2 2
0 0 0 0 4 4 4 2 2 2 2 2 2 2 2 2 2 2 2 2 4 4 4 2 2 2 2 2 1 2 2 2 2 4 2 2 2 2 1 0 0 1 1 4 4 4 2 2 2 2 2 2 2 2 2 0 0 1 2 2 2 2 1 0 0 0 1 2 2 2 2 2 2 2 4 2 2 2 2 4 4 4 2 2 4 4 4 1 1 1 2 2 2 1 2 2 2 2 2 1
0 0 0 0 4 4 4 2 2 2 2 2 2 2 2 2 2 2 2 2 2 4 2 2 2 2 2 2 1 1 2 2 2 2 2 2 2 2 1 0 0 1 2 4 4 4 2 2 2 2 2 2 2 2 2 1 0 1 2 2 2 2 1 0 0 0 1 2 2 2 2 2 2 1 2 2 2 2 2 4 4 4 1 2 4 4 4 1 1 2 2 2 2 2 2 2 2 2 2 1
0 0 0 2 4 4 4 2 2 2 2 2 2 2 2 2 2 2 2 4 4 4 2 2 2 2 2 2 1 1 2 2 2 1 1 2 2 4 4 1 1 2 2 2 4 2 2 2 2 2 2 2 2 2 2 1 1 1 2 2 2 2 2 1 0 1 1 2 2 2 2 2 1 0 0 0 1 2 2 2 4 2 1 1 2 4 2 2 2 2 2 2 4 4 4 2 2 2 2 1
0 1 2 2 2 4 3 2 2 2 2 2 2 2 2 2 2 2 2 4 4 4 3 3 3 2 2 2 2 1 1 1 1 0 0 1 2 4 4 4 4 2 2 2 2 2 2 2 2 3 2 3 2 2 2 2 2 2 2 2 2 2 2 2 1 1 1 2 2 2 2 2 1 0 0 0 1 4 4 4 2 2 1 2 2 2 2 2 2 4 4 4 4 4 4 2 2 2 2 1
1 2 2 2 3 3 3 2 2 2 2 2 2 2 2 2 2 2 2 4 4 4 3 3 3 2 2 2 2 2 2 1 0 0 0 1 2 4 4 4 4 2 2 2 4 4 4 2 3 3 3 3 3 3 2 2 2 2 2 2 2 2 2 2 2 1 1 1 1 2 2 2 2 1 0 1 2 4 4 4 2 2 2 2 2 2 2 2 2 4 4 4 4 4 4 2 2 2 2 2
2 2 2 2 3 3 3 2 5 5 2 2 2 2 2 2 2 2 2 2 4 3 3 3 3 2 2 2 2 2 2 1 0 0 0 2 2 2 4 4 4 2 3 3 4 4 4 2 3 3 3 3 3 3 2 2 2 2 2 2 2 4 4 4 2 2 2 1 1 2 2 2 2 2 1 4 4 4 4 4 2 2 2 2 2 2 2 1 1 1 1 4 2 4 2 2 2 2 2 2
2 1 4 4 4 4 3 5 2 2 5 2 2 2 2 2 2 2 2 2 2 2 2 3 2 2 2 2 2 2 2 2 1 1 1 2 2 2 2 4 2 2 3 3 4 4 4 2 3 3 3 3 3 2 2 2 2 2 2 2 2 4 4 4 2 2 2 2 2 2 2 2 2 2 4 4 4 2 4 2 2 2 2 2 2 2 1 1 0 0 4 0 1 1 2 2 2 2 2 2
1 1 1 4 4 4 3 5 5 5 5 2 2 2 2 2 2 2 2 2 2 2 2 2 4 4 4 4 4 2 2 2 2 2 2 2 2 2 2 2 2 2 3 3 3 4 2 2 3 3 3 4 4 4 2 2 2 2 2 2 2 4 4 4 2 2 2 2 2 2 2 3 2 2 4 4 4 2 2 2 2 2 5 5 2 2 2 1 1 0 0 0 0 1 1 2 2 2 2 2
1 0 4 1 4 4 3 5 5 5 5 2 2 2 2 2 2 2 2 2 1 1 2 2 4 4 4 4 4 2 2 2 2 2 2 1 1 1 2 2 4 4 4 2 2 2 2 2 3 3 3 4 4 4 4 2 2 2 2 2 2 2 4 2 2 2 2 2 2 2 2 3 3 2 2 4 4 4 4 2 2 5 4 4 5 2 2 2 2 1 0 0 0 0 1 1 1 1 2 2
1 0 0 4 1 2 2 5 5 5 5 2 2 1 1 2 2 2 2 2 1 0 1 1 4 4 4 4 4 2 2 2 2 2 2 1 0 1 2 2 4 4 4 2 2 2 2 2 2 2 2 4 4 4 4 2 2 2 2 2 2 2 2 2 4 4 4 2 2 2 3 3 3 3 2 2 4 4 4 2 2 5 5 5 5 2 2 2 2 2 2 1 0 0 0 0 0 0 0 1
1 0 0 0 0 1 2 5 5 5 5 2 2 1 1 2 2 2 2 2 1 0 0 1 1 4 2 4 2 2 2 2 2 2 2 4 1 1 2 2 4 4 4 2 2 2 2 2 2 2 2 2 4 4 4 2 2 2 2 2 2 2 2 2 4 4 4 4 4 4 2 3 3 3 2 2 4 4 4 2 2 5 5 5 5 4 2 2 2 2 2 1 0 0 0 0 0 0 0 1
2 1 0 0 4 1 4 2 2 2 2 2 2 1 2 2 2 2 2 2 1 0 0 1 2 2 2 2 2 2 2 2 2 2 2 4 4 4 2 2 2 4 2 2 2 2 1 2 2 2 2 2 2 4 3 3 3 2 2 2 2 2 2 2 4 4 4 1 4 4 2 3 3 3 3 4 4 4 2 2 2 5 5 5 5 4 2 2 2 2 2 2 1 0 0 0 0 0 0 1
2 2 1 1 1 4 4 2 1 1 1 2 2 2 2 2 2 2 2 2 1 1 1 2 2 4 4 4 2 2 2 2 2 3 2 4 4 4 2 2 2 2 2 2 2 2 1 1 1 1 1 2 2 3 3 3 3 2 2 2 2 2 2 2 2 4 1 4 4 1 2 2 3 3 3 4 4 4 2 2 2 5 5 5 5 4 4 2 2 2 2 2 2 2 1 1 1 0 0 1
2 2 2 1 4 4 4 4 1 4 1 2 2 4 4 4 2 2 2 2 2 2 2 2 2 4 4 4 4 2 2 2 2 3 2 2 4 1 1 1 2 2 2 2 2 2 1 1 1 1 1 2 2 3 3 3 3 2 2 2 2 2 2 2 2 2 1 0 4 0 1 2 2 3 3 4 4 4 2 2 2 2 2 2 4 4 4 2 2 2 2 2 2 2 2 2 2 2 1 2
2 2 2 2 2 4 4 4 4 1 1 2 2 4 4 4 2 2 2 2 2 2 2 2 2 4 4 4 4 2 2 2 2 3 3 2 2 0 0 1 2 2 2 2 2 2 2 1 1 1 1 2 2 3 3 3 2 2 2 4 4 4 2 2 2 2 1 0 0 0 1 2 2 2 3 3 4 2 2 2 2 2 1 2 4 4 4 2 2 2 2 2 2 2 2 2 2 2 2 2
2 2 2 2 2 4 4 4 4 4 2 2 2 4 4 4 2 2 2 2 2 2 2 2 4 4 4 4 4 1 1 2 2 2 2 2 2 0 0 1 2 2 2 2 2 2 2 2 1 1 2 2 2 3 3 2 2 2 2 4 4 4 2 2 2 2 2 0 0 0 1 4 4 2 3 3 2 2 2 2 2 1 1 1 2 4 2 2 2 2 2 2 2 1 1 1 1 1 2 2
2 4 4 4 2 4 4 4 4 2 2 2 2 2 4 2 2 2 2 2 2 2 2 2 4 4 4 4 2 1 1 2 2 2 2 2 2 0 0 1 2 2 2 2 2 2 2 2 1 1 2 2 3 3 2 2 2 2 2 4 4 4 2 2 2 2 1 1 1 2 4 4 4 2 3 2 2 2 2 2 2 2 2 2 2 2 2 2 2 2 2 2 1 0 0 0 0 1 2 2
2 4 4 4 4 2 4 2 2 2 2 2 2 2 2 2 2 1 1 2 2 2 2 2 4 4 4 4 4 4 4 4 2 2 2 2 2 1 1 2 2 2 2 2 2 2 2 0 0 0 2 2 3 3 2 4 4 4 2 2 4 2 2 2 2 1 0 1 2 2 4 4 4 3 3 2 2 2 2 4 4 4 2 2 2 2 2 2 2 2 2 2 1 0 0 0 0 1 2 2
2 4 4 4 4 2 2 2 2 2 2 2 2 2 2 2 1 1 1 4 4 4 2 2 2 4 2 4 4 4 4 4 2 2 2 2 2 2 2 2 2 5 5 4 4 2 1 0 0 0 1 2 2 4 4 4 4 4 2 2 2 2 2 2 1 0 0 1 2 2 2 4 3 3 4 4 4 2 2 4 4 4 2 2 2 2 2 2 2 2 2 2 2 2 1 1 2 2 2 2
2 2 4 4 4 2 1 4 4 4 2 2 2 2 2 2 1 1 2 4 4 4 2 2 2 6 6 6 6 6 6 6 6 6 6 3 3 2 2 2 5 2 4 5 4 2 1 0 0 0 1 2 2 4 4 4 4 4 2 2 2 2 2 2 1 0 0 1 2 2 2 3 2 2 4 4 4 2 1 4 4 4 2 2 2 2 2 2 2 2 2 2 2 2 2 2 2 2 2 2
2 4 4 4 2 1 1 1 4 4 2 2 2 1 2 1 2 2 2 4 4 4 2 2 4 6 6 6 6 6 6 6 6 6 6 3 3 3 3 2 5 5 5 5 4 2 2 1 1 1 1 2 2 4 4 4 4 2 2 2 2 2 2 2 2 1 1 2 2 2 2 2 2 2 4 4 1 0 0 1 4 2 2 2 2 2 2 2 2 3 3 2 2 2 2 2 2 2 2 2
2 4 4 4 2 2 1 1 4 1 1 1 1 1 1 2 2 2 2 2 4 2 2 2 4 6 6 6 6 6 6 6 6 6 6 3 3 3 3 2 5 5 5 5 2 2 2 2 2 2 2 2 2 2 4 2 2 2 1 1 1 2 2 2 2 2 2 2 2 2 2 2 2 2 2 4 0 0 0 0 2 2 2 2 2 2 2 2 2 3 3 3 2 2 2 2 2 2 2 2
2 4 4 4 2 2 2 1 4 0 0 1 1 1 2 2 2 2 2 2 2 2 2 4 4 6 6 6 6 6 6 6 6 6 6 4 3 3 2 2 5 5 5 5 2 2 2 2 2 2 2 2 2 2 2 2 2 2 1 0 1 2 2 2 2 2 2 2 2 2 2 2 2 2 2 2 1 0 0 2 2 2 2 2 2 2 2 4 4 4 3 3 2 2 2 2 2 2 2 2
2 2 4 2 2 2 2 1 0 0 0 1 1 2 2 2 2 2 1 1 2 2 2 4 4 6 6 6 6 6 6 6 6 6 6 4 3 2 2 2 5 5 5 5 2 2 2 2 2 2 2 2 2 2 2 2 2 2 1 0 0 1 2 2 2 2 2 2 2 2 2 2 2 2 2 2 2 2 2 2 2 2 2 2 2 2 2 4 4 4 3 3 2 2 2 4 4 4 1 2
2 2 2 2 2 2 2 2 1 0 0 1 1 1 2 2 2 1 0 0 1 1 1 1 4 6 6 6 6 6 6 6 6 6 6 4 2 2 2 2 2 2 4 4 4 2 2 2 2 2 2 2 2 2 2 2 2 2 2 1 0 1 2 2 2 2 2 2 2 2 2 2 2 2 2 2 2 2 2 2 2 2 2 2 2 2 2 4 4 4 2 3 3 2 2 4 4 4 1 2
2 2 2 2 2 2 2 2 2 1 1 1 1 1 1 1 1 0 0 0 0 0 0 0 4 6 6 6 6 6 6 6 6 6 6 2 2 2 2 2 2 2 4 4 4 2 2 2 2 2 2 2 2 2 2 2 2 2 2 2 1 0 1 2 2 2 2 2 2 2 2 2 2 2 2 2 2 2 2 2 2 2 2 2 2 2 2 2 4 2 2 3 3 3 2 4 4 4 2 2
2 2 2 2 2 2 2 4 4 4 1 1 0 0 0 0 0 0 0 0 0 0 0 1 2 6 6 6 6 6 6 6 6 6 6 2 2 3 2 2 2 2 4 4 4 2 2 2 2 2 2 2 2 2 2 2 2 2 2 2 2 1 1 1 2 2 2 2 2 2 2 1 2 2 2 3 3 2 2 2 2 2 2 2 2 2 2 2 2 2 2 3 3 3 3 3 4 2 2 2
4 4 4 2 2 2 2 4 4 4 1 0 1 1 1 1 0 0 0 1 1 0 0 1 2 6 6 6 6 6 6 6 6 6 6 2 4 4 4 4 4 4 2 4 2 2 2 2 2 2 2 2 2 2 1 1 2 2 2 2 2 1 1 1 2 2 2 2 2 2 2 2 2 3 3 3 3 2 2 2 2 2 2 2 2 2 1 1 0 1 2 2 3 3 3 3 3 2 2 2
4 4 4 2 2 3 3 4 4 4 1 1 1 2 2 2 1 0 0 0 1 1 1 1 2 6 6 6 6 6 6 6 6 6 6 2 4 4 4 4 4 4 2 2 2 2 2 2 2 2 2 2 2 2 1 0 1 2 2 2 2 1 1 1 2 2 2 2 2 2 2 2 2 3 3 3 3 2 2 2 2 2 2 2 2 2 1 0 0 0 2 2 4 4 4 3 3 2 2 2
4 4 4 2 2 3 3 2 4 2 1 1 2 2 2 2 2 1 0 0 1 1 1 1 1 2 2 2 2 2 4 2 2 1 1 4 4 4 4 4 4 4 2 2 2 2 2 2 2 2 2 2 2 2 0 0 0 2 2 2 2 1 0 1 2 2 2 2 2 2 2 2 2 3 3 3 2 2 2 2 2 2 2 2 2 2 2 0 0 0 2 2 4 4 4 2 2 2 2 2
2 4 2 2 2 3 3 2 2 2 1 2 2 2 2 2 2 1 1 1 1 2 1 1 1 1 2 2 2 2 2 2 2 1 1 4 4 4 2 4 4 2 2 2 2 2 2 2 2 2 2 2 2 2 0 0 0 1 2 4 4 1 0 0 1 2 2 2 1 1 1 2 2 2 2 2 2 2 2 2 2 2 2 2 2 2 2 1 0 0 2 2 4 4 4 2 2 2 2 2
2 2 2 2 3 2 2 2 2 1 1 2 2 2 2 2 2 2 2 2 2 2 2 2 1 1 1 2 2 2 2 2 2 2 1 4 4 4 2 2 4 4 4 1 0 1 2 2 2 2 2 2 2 2 0 0 0 1 4 4 4 4 0 0 0 1 1 1 1 0 1 2 2 2 2 2 2 2 2 2 2 2 2 2 2 2 2 2 2 2 2 2 2 4 2 2 2 2 2 2
2 2 2 3 2 2 2 2 1 0 0 0 2 2 2 2 2 2 2 2 2 2 2 2 2 2 2 2 2 2 2 2 2 2 2 2 4 2 2 2 4 4 4 0 0 1 2 2 2 2 2 2 2 4 4 1 1 2 4 4 4 4 0 0 0 0 1 1 1 1 2 2 2 2 2 2 2 2 2 2 2 2 2 2 2 2 2 2 2 2 2 2 2 2 2 2 1 1 2 2
2 2 2 2 2 2 2 1 0 0 0 0 1 2 2 4 4 4 2 2 2 2 2 2 2 2 2 2 2 2 2 2 2 2 2 2 2 4 4 4 4 4 1 1 0 1 2 2 2 2 2 2 2 4 4 4 2 2 4 4 4 1 0 0 0 0 0 1 2 2 2 4 4 4 4 4 2 2 2 2 2 2 2 2 2 4 4 4 4 4 4 2 2 2 2 1 0 0 0 2
2 2 2 2 2 2 2 1 0 0 0 0 0 2 2 4 4 4 2 2 4 4 4 3 3 2 2 2 2 2 1 2 2 2 2 2 2 4 4 4 4 4 2 2 2 2 2 2 2 2 2 2 2 4 4 4 2 2 2 4 2 1 1 0 0 0 0 1 2 2 2 4 4 4 4 4 2 2 2 2 2 2 2 2 2 4 4 4 4 4 4 2 2 2 2 0 0 0 0 1
4 4 4 2 2 2 2 2 1 0 0 0 0 2 2 4 4 4 2 2 4 4 4 3 3 3 2 2 2 1 1 1 2 2 2 2 2 4 4 4 4 2 2 2 2 2 2 2 2 2 2 2 2 2 4 4 4 2 2 2 2 2 2 2 1 0 0 0 2 4 4 4 4 4 4 4 2 2 1 1 1 2 2 2 2 4 4 4 4 4 4 2 2 2 2 0 0 0 0 0
4 4 4 2 2 2 2 2 2 1 0 0 1 2 2 2 4 2 1 2 4 4 4 3 3 3 2 2 2 1 1 1 2 2 1 2 2 2 4 4 2 2 2 2 2 2 2 2 2 2 2 2 2 2 4 4 4 2 4 4 4 2 2 2 2 0 0 0 2 4 4 4 4 2 4 2 2 2 1 0 0 1 2 2 2 2 4 2 4 4 4 2 2 2 2 1 0 0 0 0
1 4 4 4 4 4 2 2 2 1 0 1 1 2 2 2 2 1 1 1 2 4 3 3 3 2 2 2 2 1 1 1 2 2 1 1 2 2 2 2 2 2 2 2 2 2 2 2 2 4 4 4 2 2 4 4 4 2 4 4 4 2 2 2 2 1 0 0 2 4 4 4 2 2 2 2 2 2 1 1 4 1 4 2 2 2 2 2 4 4 4 2 2 2 2 2 0 0 0 0
0 4 2 4 4 4 2 2 2 2 1 0 1 2 2 2 2 1 1 2 2 3 3 3 3 2 2 2 2 1 1 1 2 2 1 2 2 2 2 2 2 2 2 2 2 2 2 2 2 4 4 4 2 2 2 4 4 4 4 4 4 2 2 2 2 1 1 1 2 2 4 2 2 4 4 4 2 2 2 2 1 4 4 2 2 2 2 2 2 4 2 2 2 2 2 2 1 0 0 0
1 2 2 4 4 4 4 2 2 2 1 0 0 1 2 2 2 2 2 2 2 2 3 3 2 2 2 2 2 1 1 1 2 2 2 2 2 2 2 2 2 2 2 2 2 2 2 2 2 4 4 4 2 2 2 4 4 4 2 4 2 2 2 2 2 2 2 2 2 2 2 2 4 4 4 4 2 2 2 2 4 4 4 2 2 2 2 2 2 2 2 2 2 2 4 4 4 0 0 0
1 2 2 2 4 4 4 4 4 2 1 0 0 1 2 2 2 2 2 2 2 2 2 2 2 2 2 2 2 1 1 1 2 2 2 2 2 2 2 2 2 2 2 2 2 2 2 2 2 2 4 2 2 2 2 4 4 4 3 3 3 3 2 2 2 2 2 2 2 2 2 2 4 4 4 4 2 2 2 2 2 4 2 2 2 2 2 2 2 2 2 1 1 1 4 4 1 0 0 0
1 1 2 2 4 4 4 4 4 2 2 1 1 2 2 2 3 3 3 2 2 2 2 2 2 2 2 2 2 2 2 2 2 2 2 2 2 2 4 4 4 4 4 4 2 2 2 2 2 2 2 2 2 2 2 2 4 2 3 3 4 4 4 2 2 2 2 2 2 2 2 2 4 4 4 2 2 1 1 1 1 1 4 4 4 2 2 2 2 2 2 1 0 0 4 4 4 0 0 0
0 1 2 2 2 4 4 4 4 2 2 2 2 2 2 2 3 3 3 2 2 2 2 2 2 2 2 2 4 4 4 2 2 2 2 2 2 2 4 4 4 4 4 4 2 2 2 2 2 4 4 4 2 2 2 2 2 2 3 3 4 4 4 2 2 2 2 2 2 2 2 2 1 4 2 2 1 0 0 0 0 1 4 4 4 2 2 2 2 2 2 1 0 0 0 4 0 0 0 0
0 1 2 2 2 2 2 4 2 2 2 2 2 2 2 2 2 2 2 2 2 2 2 2 2 2 1 2 4 4 4 2 2 2 2 2 2 2 4 4 4 4 4 4 2 2 2 2 2 4 4 4 2 2 2 2 2 2 2 3 4 4 4 2 4 4 4 2 2 2 2 2 1 2 2 2 1 0 0 0 1 2 4 4 4 2 2 2 2 2 2 1 0 0 0 0 0 0 0 0
0 2 4 4 4 2 2 2 2 3 2 2 2 2 2 2 2 2 2 2 2 2 2 2 2 2 1 4 4 4 4 2 2 2 2 2 2 4 4 4 3 2 4 2 3 3 3 2 2 4 4 4 2 2 2 2 2 2 2 2 2 4 2 2 4 4 4 2 2 2 2 1 1 1 2 2 2 1 1 1 2 2 2 4 2 2 2 2 2 2 1 1 1 1 1 0 1 0 0 0
1 2 4 4 4 2 2 2 2 3 3 3 2 2 2 2 2 2 2 2 2 2 2 2 2 2 1 4 4 4 2 2 2 2 2 2 2 4 4 4 3 2 4 4 4 3 3 2 2 2 4 2 2 2 2 2 2 2 2 2 2 2 2 2 4 4 4 2 2 2 1 1 0 1 2 2 2 2 2 2 2 2 2 2 2 2 2 2 2 2 1 1 1 2 1 1 1 1 0 0
2 2 4 4 4 2 2 2 2 3 3 3 2 2 2 2 2 2 2 1 1 2 2 2 2 2 1 4 4 4 2 1 1 1 2 2 2 4 4 4 2 2 4 4 4 2 2 2 2 2 2 2 2 4 4 4 2 2 2 2 2 4 4 4 2 4 2 2 2 2 1 0 0 1 2 2 2 2 2 2 2 2 2 2 2 3 2 2 2 2 2 1 2 2 4 4 4 1 1 2
2 2 2 4 2 2 2 4 4 4 2 3 2 2 2 2 2 2 1 0 0 2 2 4 4 4 1 1 4 2 2 1 1 1 2 2 2 2 4 4 4 4 4 4 4 2 2 2 2 2 2 2 2 4 4 4 2 2 2 2 2 4 4 4 2 2 2 2 2 2 2 1 1 2 2 2 2 2 2 2 2 2 2 2 2 2 2 2 4 4 4 2 2 2 4 4 4 2 2 2
2 2 2 2 2 2 2 4 4 4 2 2 2 2 2 2 2 2 1 0 1 2 2 4 4 4 1 1 1 2 2 1 1 1 2 2 2 2 2 4 4 4 4 4 4 1 0 0 1 1 2 2 2 4 4 4 2 2 3 3 2 4 4 4 2 2 3 3 3 2 2 2 2 2 2 2 2 2 2 4 4 4 2 2 2 2 2 2 4 4 4 4 4 4 4 4 4 2 2 2
2 2 2 2 2 2 2 4 4 4 2 2 2 2 2 2 2 2 1 1 2 2 2 4 4 1 1 1 1 2 2 2 1 1 1 2 2 2 2 4 4 4 4 4 4 4 0 0 1 2 2 2 2 2 4 2 2 2 2 2 2 2 4 4 4 4 4 3 3 3 2 2 2 2 2 2 2 2 2 4 4 4 2 2 2 2 2 2 4 4 4 4 4 4 2 4 2 2 2 2
1 0 0 1 2 2 2 2 4 2 2 2 2 2 2 2 2 1 1 1 2 2 2 2 4 1 0 0 1 2 2 2 2 2 2 2 2 2 1 2 4 2 4 4 4 1 1 2 2 4 4 4 2 2 2 4 4 4 2 2 2 2 2 4 4 4 4 3 3 3 2 2 2 2 2 2 2 2 2 4 4 4 2 2 2 2 2 3 2 4 2 4 4 4 2 2 2 2 2 2
1 0 0 0 2 2 2 2 2 2 2 3 3 2 2 2 1 1 1 1 2 2 2 2 2 1 0 1 1 2 2 2 2 2 2 2 2 2 1 1 2 2 2 4 4 4 2 2 2 4 4 4 2 2 2 4 4 4 2 2 2 2 2 4 4 4 4 2 2 2 4 4 4 2 2 2 2 2 2 4 4 4 2 2 2 2 2 3 3 4 4 4 4 2 2 2 2 2 2 2
1 0 0 1 1 2 2 2 2 2 2 3 3 2 2 1 1 1 1 1 2 2 2 2 2 1 1 1 2 2 2 2 2 2 2 2 2 2 2 1 1 1 2 2 4 2 2 2 2 4 4 4 2 2 2 4 4 4 2 2 2 2 2 2 4 4 2 2 2 2 4 4 4 2 2 2 2 2 2 4 4 4 4 1 1 2 2 3 3 4 4 4 2 2 2 2 2 2 2 2
2 1 1 1 1 2 2 2 2 2 2 3 4 4 4 2 2 2 2 2 2 2 2 2 2 4 4 4 2 2 2 2 2 2 2 2 2 2 2 2 1 1 1 2 2 2 2 2 2 2 4 2 2 2 2 2 4 2 2 2 2 2 2 2 2 2 2 2 2 2 4 4 4 2 2 2 1 1 2 2 4 4 4 1 1 2 2 2 2 4 4 4 2 2 2 2 2 2 2 2
2 2 2 2 2 1 1 1 2 2 2 3 4 4 4 2 2 2 2 2 2 2 2 2 2 4 4 4 2 2 2 2 2 2 2 2 2 2 2 2 2 1 1 2 2 2 2 2 2 2 2 2 2 2 2 2 2 2 2 2 2 2 2 2 2 2 2 2 2 2 2 4 2 2 2 1 1 1 2 2 4 4 4 1 1 2 2 2 2 2 4 2 2 2 2 2 2 2 2 2
2 2 2 2 2 1 1 1 1 2 2 2 4 4 4 2 2 4 4 4 1 2 1 1 2 2 4 2 2 2 2 2 2 2 2 2 2 2 2 2 2 4 4 4 2 2 2 2 2 2 2 2 1 0 1 2 2 2 2 2 2 2 2 2 2 2 2 2 1 2 2 2 2 2 2 2 1 2 2 4 4 4 2 1 2 2 2 2 2 2 2 2 2 2 2 2 2 2 2 2
2 2 2 2 2 2 1 1 2 4 4 4 4 4 4 2 2 4 4 4 2 1 1 0 1 2 2 2 2 2 2 4 4 4 2 2 2 2 2 2 2 4 4 4 2 2 2 2 2 2 2 1 0 0 2 2 2 2 2 2 2 1 2 2 2 2 2 2 2 2 2 2 2 2 2 2 2 4 4 4 4 4 4 1 2 2 2 2 2 2 2 2 2 3 2 2 2 1 2 2
2 2 2 2 2 2 2 2 2 4 4 4 4 4 4 2 2 4 4 4 2 1 0 0 0 2 2 2 2 2 2 4 4 4 2 2 2 2 2 2 2 4 4 4 2 4 4 4 2 2 2 1 1 1 2 2 2 2 2 2 1 1 2 2 2 2 2 2 2 2 4 4 4 2 2 2 2 4 4 4 4 4 4 1 2 2 2 2 2 2 2 2 2 2 2 2 1 1 2 2
2 2 2 2 2 2 2 2 2 4 4 4 4 4 4 2 2 2 4 2 2 1 0 0 0 2 2 2 2 2 2 4 4 4 2 2 2 2 2 2 2 2 4 2 2 4 4 4 2 2 2 2 1 2 2 2 2 2 2 2 1 1 2 2 2 2 2 2 2 2 4 4 4 2 2 2 2 4 4 4 4 4 4 1 2 2 2 2 2 2 2 2 2 2 2 2 1 1 2 2
2 2 2 2 2 2 2 2 2 2 4 2 2 4 2 2 2 2 2 2 2 1 1 1 1 2 2 2 2 2 2 2 4 2 2 2 4 4 4 2 2 2 2 2 2 4 4 4 2 2 2 2 2 1 1 2 2 2 2 1 1 4 4 4 2 2 2 4 4 4 4 4 4 2 4 4 4 2 4 2 2 4 2 2 2 2 2 2 2 2 2 2 2 2 2 2 2 1 2 2
2 1 1 1 2 2 4 4 4 2 2 2 2 2 2 2 2 2 2 2 2 2 4 4 4 2 2 2 2 2 2 2 2 2 2 2 4 4 4 2 2 2 4 4 4 4 4 4 2 2 2 2 1 0 0 1 2 2 2 2 1 4 4 4 2 2 2 4 4 4 2 4 2 2 4 4 4 2 2 2 2 2 2 2 2 2 2 2 2 2 2 2 2 2 2 2 2 2 2 2
0 0 0 1 2 2 4 4 4 2 2 2 2 2 1 1 2 2 2 2 2 2 4 4 4 2 2 2 2 2 2 2 2 2 2 2 4 4 4 2 2 2 4 4 4 4 4 4 2 2 4 4 4 0 0 1 2 2 2 2 2 4 4 4 2 2 2 4 4 4 4 1 1 1 4 4 4 2 2 2 2 2 2 4 4 4 2 2 2 2 2 2 2 2 2 2 2 2 1 1
0 0 0 1 2 2 4 4 4 2 2 2 1 1 1 1 4 4 4 2 2 2 4 4 4 2 2 2 2 2 2 2 2 2 2 2 2 4 2 2 2 2 4 4 4 4 4 4 2 2 4 4 4 1 1 1 2 2 2 2 2 2 4 4 4 4 4 4 4 4 4 1 1 1 2 4 2 2 2 2 2 2 2 4 4 4 2 2 2 2 2 2 2 2 2 2 2 2 2 0
0 0 0 1 1 1 1 4 4 2 2 2 1 0 1 4 4 4 4 2 2 2 2 4 4 4 4 2 2 2 2 2 2 2 2 2 2 2 2 2 4 4 4 4 4 4 4 2 2 2 4 4 4 2 2 2 2 2 3 3 3 4 4 4 4 4 4 1 1 1 4 1 1 1 1 2 2 2 2 2 2 2 2 4 4 4 2 2 1 1 2 2 2 2 2 2 2 2 2 0
0 0 0 1 0 0 0 1 2 2 2 2 1 1 1 4 4 4 4 3 3 2 2 2 4 4 4 2 2 2 2 1 2 2 2 2 2 2 2 2 4 4 4 4 4 4 4 2 5 5 2 4 2 2 2 2 2 2 3 3 3 4 4 4 4 1 4 4 0 1 1 1 1 1 2 2 2 2 2 2 2 2 2 2 4 2 2 2 2 2 2 2 2 2 2 2 2 2 2 1
0 0 1 1 0 0 0 0 2 2 2 2 1 1 2 4 4 4 2 3 3 2 2 4 4 4 4 2 2 2 1 1 1 2 2 2 2 2 2 2 4 4 4 4 4 4 4 5 2 4 5 4 2 2 2 2 2 2 2 2 2 4 4 4 4 1 1 0 0 1 2 2 2 1 1 2 2 2 2 2 2 2 2 2 2 4 4 4 2 2 2 2 1 1 2 2 2 2 2 2
1 0 1 1 1 1 1 2 5 5 2 2 1 1 2 2 4 2 2 3 2 2 2 4 4 4 2 2 2 2 1 1 1 2 2 2 2 2 2 2 2 4 2 2 4 4 4 5 5 5 5 4 2 2 2 2 2 2 2 2 2 2 4 4 4 2 1 1 1 2 2 2 2 1 1 1 2 2 2 2 1 1 2 2 2 4 4 4 2 2 2 2 4 4 4 2 2 2 2 2
1 1 1 2 2 2 2 5 2 2 5 2 1 1 2 2 4 4 4 2 2 2 2 4 4 4 2 2 2 2 1 1 1 1 2 2 2 2 2 2 2 2 2 2 2 4 2 5 5 5 5 4 2 2 2 2 2 2 2 2 2 4 4 4 4 2 2 2 2 2 2 2 2 1 0 1 2 2 2 2 1 1 1 2 2 4 4 4 2 2 2 2 4 4 4 1 1 2 2 2
1 1 2 2 4 4 4 5 5 5 5 2 1 1 1 2 4 4 4 2 2 2 2 2 4 2 2 2 2 2 1 0 0 1 1 2 1 1 0 1 1 1 1 1 1 2 2 5 5 5 5 2 2 2 2 2 2 2 2 2 2 4 4 4 4 4 4 2 2 2 2 2 2 1 1 1 2 2 2 2 1 1 1 2 2 2 4 2 2 2 2 2 4 4 4 2 1 2 2 2
2 2 2 2 4 4 4 5 5 5 5 2 1 1 1 2 4 4 4 2 2 2 2 2 2 2 2 2 2 2 1 0 1 1 2 2 2 0 0 0 0 0 0 1 1 2 2 5 5 5 5 2 2 2 2 2 2 2 2 2 2 4 4 4 4 4 4 2 2 2 2 2 2 2 1 2 2 2 2 2 2 1 1 1 2 2 2 2 2 2 4 4 4 4 2 2 2 2 2 2
2 2 2 2 4 4 4 5 5 5 5 0 0 0 1 2 2 4 2 2 2 2 4 4 4 4 4 4 2 2 1 0 1 2 2 2 2 1 0 0 0 0 0 1 1 2 2 2 2 2 1 1 2 2 2 2 2 2 2 2 2 2 4 4 4 4 4 2 2 2 2 2 2 2 2 2 2 2 2 2 2 1 1 2 2 2 2 2 4 4 4 4 4 2 2 2 2 2 2 2
4 4 4 1 1 4 2 5 5 1 5 0 0 0 0 1 2 2 2 2 2 2 4 4 4 4 4 4 2 2 2 1 1 1 2 2 2 2 1 0 0 0 1 1 2 2 2 2 2 1 1 1 2 2 2 4 4 4 2 1 0 0 1 2 2 4 2 2 2 2 2 2 2 2 2 2 2 2 2 2 1 1 1 2 2 2 2 2 4 4 4 4 4 4 4 2 2 2 2 2
4 4 4 4 1 1 2 2 2 1 0 0 0 0 0 1 2 2 2 2 2 2 4 4 4 4 4 4 2 2 2 2 1 1 1 2 2 2 2 2 2 2 1 2 2 2 2 2 2 1 1 1 2 2 2 4 4 4 1 0 0 0 0 1 2 1 0 0 1 2 2 2 2 2 2 2 2 2 2 2 0 0 1 2 2 4 4 4 4 4 4 4 4 4 4 2 2 2 2 2
4 4 4 4 1 2 2 2 2 2 1 0 0 0 0 1 2 2 2 2 2 2 2 4 2 2 4 2 2 2 2 2 2 1 1 1 2 2 4 4 4 2 2 2 2 2 2 2 2 2 1 2 2 2 2 4 4 4 1 0 0 0 0 1 1 0 0 0 1 2 2 2 2 2 2 2 2 2 2 0 0 0 0 2 2 4 4 4 2 4 2 2 4 4 4 2 2 1 2 2
4 4 4 4 2 2 2 2 2 2 2 2 1 1 1 2 2 2 2 2 2 2 2 2 2 2 2 2 2 2 2 2 2 2 1 1 2 2 4 4 4 2 2 2 2 2 2 2 2 2 2 2 2 2 2 2 4 2 2 2 1 1 1 1 1 0 0 0 1 2 2 2 2 2 2 2 2 2 1 0 0 0 0 2 2 4 4 4 2 2 2 2 2 4 2 2 2 2 2 2
2 4 4 2 1 1 0 1 1 2 2 2 2 1 2 2 2 2 2 2 2 2 1 1 0 1 2 2 2 2 2 2 2 2 2 2 2 2 4 4 4 2 2 2 2 2 2 2 4 4 4 2 2 2 2 2 2 2 2 2 2 2 1 1 1 1 0 1 2 2 2 2 2 2 2 2 2 1 0 0 0 0 1 2 2 2 4 4 4 4 2 2 2 2 2 2 2 2 2 2
2 2 2 2 0 0 0 0 0 1 1 2 2 1 2 2 2 2 2 2 2 1 0 0 0 0 2 2 2 2 2 2 2 5 5 2 2 2 2 4 2 4 4 4 2 2 2 2 4 4 4 2 2 2 4 4 4 2 2 2 2 4 4 4 2 2 4 4 4 1 1 1 2 2 2 2 2 1 0 0 0 1 2 2 2 2 2 4 4 4 4 2 2 2 2 2 2 2 2 2
2 2 2 2 0 0 0 0 0 1 2 2 2 1 2 2 2 2 2 2 2 0 0 0 0 0 1 2 2 2 4 4 5 2 2 5 2 2 2 2 2 4 4 4 2 2 2 2 4 4 4 2 2 2 4 4 4 2 2 2 2 4 4 4 2 2 4 4 1 0 0 0 0 2 2 2 1 0 0 0 0 2 2 2 2 2 2 4 4 4 4 2 2 2 3 3 3 2 2 2
2 2 2 2 0 0 0 0 0 2 2 2 2 2 2 4 4 4 2 2 2 0 0 0 0 0 1 2 2 2 4 4 5 5 5 5 2 2 2 2 2 4 4 4 2 2 2 2 2 4 2 2 2 2 4 4 4 2 2 2 2 4 4 4 4 2 4 4 1 0 0 0 0 1 2 2 1 1 0 0 1 2 2 2 2 2 2 2 4 4 4 2 2 2 3 3 3 2 2 2
2 2 2 2 1 0 0 1 2 2 2 2 2 2 2 4 4 4 2 2 2 1 0 0 0 0 2 2 2 2 4 4 5 5 5 5 2 4 4 4 2 2 4 2 2 2 2 2 1 1 1 1 2 2 2 4 2 2 2 2 2 2 4 4 4 2 4 4 4 0 0 0 0 0 1 1 1 0 0 0 1 2 2 2 2 2 2 2 1 4 2 2 2 2 2 2 2 2 2 2
2 2 2 2 2 2 2 2 2 2 2 2 2 2 2 4 4 4 2 2 2 1 1 0 1 1 2 2 2 2 1 4 5 5 5 5 2 4 4 4 2 2 2 2 2 2 2 1 0 0 0 0 0 1 2 2 1 1 2 2 2 2 4 4 4 2 4 4 4 0 0 0 0 0 0 1 0 1 0 0 0 2 2 2 2 2 2 2 2 1 1 2 2 2 2 2 2 2 2 2
2 3 2 2 2 2 2 2 4 4 4 4 2 2 2 4 4 4 4 4 2 2 1 2 2 2 2 2 1 1 1 1 5 5 5 5 2 4 4 4 2 4 4 4 2 2 2 1 0 0 0 0 0 1 2 2 1 1 2 2 2 2 2 4 2 2 4 4 4 1 0 0 0 0 0 0 1 1 1 0 1 2 2 2 2 2 2 2 2 2 1 1 1 2 2 2 2 2 2 2
3 3 3 2 2 2 2 2 4 4 4 4 2 2 2 4 4 4 4 4 2 2 2 2 2 2 2 1 1 1 1 1 2 2 2 2 2 2 4 2 2 4 4 4 2 2 2 2 2 1 1 0 0 0 1 2 2 1 2 2 2 2 2 2 2 2 2 4 1 0 0 0 0 0 0 1 1 2 1 1 1 2 2 2 2 2 2 2 2 2 2 1 2 1 1 1 1 2 2 2
3 3 3 3 2 2 2 2 4 4 4 4 2 1 1 4 4 4 4 4 2 2 2 2 2 2 2 2 2 2 2 2 4 4 4 2 2 2 2 2 2 4 4 4 4 4 4 2 4 4 4 1 0 0 1 2 2 2 2 2 2 2 2 2 2 2 2 2 0 0 0 1 0 0 0 1 2 2 2 1 1 2 2 2 4 4 4 2 2 2 2 2 2 2 2 2 2 2 2 3
3 3 3 2 2 2 2 2 2 4 4 4 2 0 0 1 4 2 4 2 2 2 2 2 2 2 2 2 2 2 2 2 4 4 4 4 4 2 2 2 2 2 4 2 4 4 4 2 4 4 4 1 0 0 1 2 2 2 2 2 2 3 2 2 2 2 2 1 0 0 0 1 0 0 0 1 2 2 2 1 1 2 2 2 4 4 4 2 2 2 2 2 2 2 2 2 2 2 2 3
3 3 2 2 2 2 2 2 2 4 4 4 1 0 0 0 2 2 3 2 2 2 2 2 2 2 2 2 2 2 2 2 4 4 4 4 4 2 2 2 2 2 2 2 4 4 4 2 4 4 4 1 0 0 1 2 2 2 2 2 2 3 3 2 2 4 4 1 0 0 0 1 0 0 0 1 2 2 1 0 0 1 2 2 4 4 4 2 2 2 2 2 2 2 2 2 2 2 2 3
2 2 2 2 2 1 1 2 2 4 4 4 2 0 0 1 2 2 3 2 2 2 2 2 3 3 3 3 3 2 4 4 4 4 4 4 4 2 2 2 2 2 2 2 2 4 2 2 2 4 1 0 0 0 1 2 2 2 2 2 2 2 2 2 2 4 4 4 1 1 1 1 1 0 1 2 2 2 0 0 0 1 2 2 4 4 4 2 2 2 2 2 2 2 2 2 2 2 2 2
2 2 2 2 2 1 0 1 2 2 4 2 2 0 0 1 2 2 2 2 2 2 2 2 3 3 3 3 3 3 4 4 4 2 2 4 2 1 1 1 2 2 2 2 2 2 2 2 2 2 1 1 1 1 2 2 2 2 2 2 2 2 2 2 2 4 4 4 4 4 2 2 1 1 2 2 2 2 0 0 0 0 2 2 4 4 4 2 2 2 2 2 2 2 2 2 2 2 2 2
2 2 2 2 2 1 0 0 1 1 2 2 2 1 1 2 2 2 2 2 2 2 2 2 2 3 2 4 4 4 4 4 4 2 2 2 2 1 0 0 0 1 1 2 2 2 2 2 2 2 2 1 4 4 4 2 2 2 2 2 2 2 2 2 2 2 4 4 4 4 2 2 1 1 2 2 2 2 1 0 0 0 2 2 4 4 4 2 1 2 2 2 2 2 2 2 2 2 2 2
2 2 2 2 2 1 1 1 1 1 2 2 2 2 2 2 2 2 2 2 2 2 2 2 2 2 4 4 4 4 4 4 2 2 2 2 2 1 0 0 0 0 0 0 1 4 4 2 2 2 1 2 4 4 4 2 2 2 2 2 2 2 2 2 2 2 2 3 4 2 2 1 0 1 2 2 2 2 1 0 0 0 2 2 2 4 2 1 1 2 2 2 2 2 2 2 2 2 2 2
2 2 2 2 2 2 2 1 1 4 4 4 2 2 2 2 2 2 2 2 2 2 4 4 4 4 4 4 4 4 4 4 2 2 2 2 2 1 4 4 0 0 0 0 1 4 4 2 2 2 2 1 4 4 4 2 2 2 2 2 2 2 2 2 2 2 2 2 2 2 2 1 0 0 2 2 2 2 2 0 0 1 4 4 4 2 2 0 1 1 2 2 2 2 2 2 2 2 2 2
2 2 2 2 2 2 2 2 2 4 4 4 2 2 2 2 2 2 2 2 2 2 4 4 4 4 4 4 4 2 4 2 2 2 2 2 2 4 4 4 2 1 1 1 1 4 4 2 2 2 2 2 2 4 2 2 2 2 2 2 2 2 2 2 2 2 2 2 2 2 2 1 0 0 1 2 2 2 2 2 1 2 4 4 4 2 2 1 1 1 1 2 2 2 2 2 2 2 2 2
2 1 2 2 2 2 2 2 2 4 4 4 2 2 2 2 2 1 1 2 2 2 4 4 4 4 4 4 2 2 2 2 2 2 2 2 2 4 4 4 2 2 1 1 4 4 4 2 2 2 2 2 2 2 2 2 2 2 2 2 2 2 2 2 2 2 2 2 2 2 2 1 1 1 1 2 2 2 2 2 2 2 4 4 4 2 2 2 1 1 1 2 2 2 2 2 3 2 2 2
1 1 2 2 2 2 2 2 1 1 4 2 2 2 2 2 2 1 1 2 2 2 2 4 2 4 2 2 2 2 2 1 1 1 2 2 2 2 4 2 2 2 2 1 1 4 2 2 2 2 2 2 2 2 2 2 2 2 2 2 2 2 2 2 2 2 2 2 2 2 2 2 2 1 2 2 2 2 2 2 2 2 2 4 2 2 2 2 2 2 2 2 2 2 2 3 3 2 2 2
