28 26 26 26 26 26 26 26 26 26 26 26 26 26 26 26 26 26 26 26 26 26 26 26 26 26 26 26 26 26 26 26 26 26 26 26 26 26 26 26 26 26 26 26 26 26 26 26 26 29
24 1 1 1 1 1 1 1 1 1 1 16 16 16 16 16 16 16 32 32 32 32 32 16 16 16 16 16 16 16 16 16 16 16 16 16 16 16 16 16 16 16 16 16 16 16 16 16 16 23
24 1 2 1 1 1 1 2 1 1 1 1 16 16 16 16 16 16 32 17 36 17 32 16 16 16 16 1 1 1 1 1 1 1 16 16 16 16 16 16 16 16 16 16 16 16 1 1 1 23
24 1 1 1 1 2 1 1 1 1 2 1 1 16 16 16 16 16 32 17 17 17 32 16 16 16 1 1 2 1 1 2 1 1 2 1 16 16 16 16 16 16 16 1 2 1 1 2 1 23
24 1 1 1 1 1 1 2 1 2 1 1 1 1 16 16 16 16 32 17 17 17 32 16 16 1 1 1 1 1 2 1 1 1 1 1 1 1 16 16 16 1 1 1 1 1 1 1 1 23
24 1 1 12 10 10 10 10 10 10 10 10 10 10 10 10 10 10 10 10 10 10 10 10 10 10 10 10 10 10 10 10 10 10 10 10 10 10 10 10 10 10 10 10 10 10 13 1 1 23
24 2 1 8 3 3 3 3 3 3 3 3 3 3 3 3 3 3 3 3 3 3 3 3 3 3 3 3 3 3 3 3 3 3 3 3 3 3 3 3 3 3 3 3 3 3 7 1 1 23
24 1 2 8 3 3 3 3 3 3 3 3 3 3 3 3 3 3 3 3 3 3 3 3 3 3 3 3 3 3 3 3 3 3 3 3 3 3 3 3 3 3 3 3 3 3 7 2 1 23
24 1 1 8 3 3 3 3 3 3 3 3 3 3 3 3 3 3 3 3 3 3 3 3 3 3 3 3 3 3 3 3 3 3 3 3 3 3 3 3 3 3 3 3 3 3 7 1 1 23
24 1 2 14 5 5 5 5 5 5 5 5 5 5 5 5 5 5 5 5 5 5 5 5 5 5 5 5 5 5 5 5 5 5 5 5 5 5 5 5 5 5 6 3 3 3 7 1 1 23
24 1 1 1 1 1 1 1 2 1 1 1 1 1 1 16 16 16 16 16 16 16 16 16 16 16 16 16 16 16 16 16 16 16 16 16 16 16 16 16 16 16 8 3 3 3 7 1 1 23
24 16 1 1 2 2 1 1 1 1 2 1 16 16 16 16 16 16 16 16 16 16 16 16 16 16 16 16 16 16 16 16 1 1 1 1 16 16 16 16 16 16 8 3 3 3 7 1 1 23
24 16 16 1 1 1 1 2 1 1 1 16 16 16 16 1 1 2 1 16 16 16 16 16 16 16 16 16 16 16 16 1 1 2 1 1 1 1 16 16 16 16 8 3 3 3 7 1 1 23
24 16 16 16 1 1 1 1 1 1 16 16 16 16 1 1 1 1 1 1 1 16 16 16 16 16 16 16 16 16 1 1 2 1 1 1 1 1 1 16 16 16 8 3 3 3 7 1 2 23
24 16 16 16 16 16 16 16 16 16 16 16 16 1 1 1 2 1 1 2 1 1 16 16 16 16 16 16 16 1 1 2 1 1 2 1 1 1 1 16 16 16 8 3 3 3 7 1 1 23
24 16 16 16 16 16 16 16 16 16 16 1 1 1 1 1 1 1 1 1 1 1 1 16 16 16 16 16 1 1 1 1 1 1 1 1 1 2 1 16 16 16 8 3 3 3 7 2 1 23
24 16 16 16 16 16 16 16 16 16 1 1 2 1 2 2 1 1 2 1 1 1 1 1 16 16 16 16 1 2 1 1 12 10 10 10 13 1 1 16 16 16 8 3 3 3 7 1 1 23
24 16 16 16 16 16 1 1 1 1 1 1 1 1 1 1 1 1 1 2 1 1 1 1 1 16 16 1 1 1 1 1 8 3 3 3 7 1 1 16 16 16 8 3 3 3 7 1 1 23
24 16 16 16 1 1 1 1 2 1 1 1 1 1 2 1 1 1 1 1 1 1 1 1 1 1 16 1 1 2 1 1 8 3 3 3 7 1 1 2 16 16 8 3 3 3 7 1 1 23
24 16 16 12 10 10 10 10 10 10 10 10 10 10 10 10 10 10 10 10 10 10 10 10 10 10 10 10 10 10 10 10 11 3 3 3 7 1 1 1 16 16 8 3 3 3 7 1 1 23
24 16 16 8 3 3 3 3 3 3 3 3 3 3 3 3 3 3 3 3 3 3 3 3 3 3 3 3 3 3 3 3 3 3 3 3 7 2 1 1 16 16 8 3 3 3 7 1 1 23
24 16 16 8 3 3 3 3 3 3 3 3 3 3 3 3 3 3 3 3 3 3 3 3 3 3 3 3 3 3 3 3 3 3 3 3 7 1 1 1 16 16 8 3 3 3 7 1 1 23
24 16 16 8 3 3 3 3 3 3 3 3 3 3 3 3 3 3 3 3 3 3 3 3 3 3 3 3 3 3 3 3 3 3 3 3 7 2 1 2 16 16 8 3 3 3 7 1 1 23
24 16 16 8 3 3 3 4 5 5 5 5 5 5 5 5 5 5 5 5 5 5 5 5 5 5 6 3 3 3 4 5 5 5 5 5 15 1 1 16 16 16 8 3 3 3 7 2 1 23
24 16 16 8 3 3 3 7 16 1 1 1 1 1 2 1 1 1 1 1 1 1 1 1 16 16 8 3 3 3 7 16 1 1 2 1 1 1 16 16 16 16 8 3 3 3 7 1 1 23
24 16 16 8 3 3 3 7 16 16 1 1 2 1 1 1 1 1 1 2 1 1 1 16 16 16 8 3 3 3 7 16 16 1 1 1 1 16 16 16 16 16 8 3 3 3 7 1 1 23
24 16 16 8 3 3 3 7 16 16 16 1 1 1 1 2 1 1 1 1 16 16 16 16 16 16 8 3 3 3 7 16 16 16 1 1 16 16 16 16 16 16 8 3 3 3 7 1 1 23
24 16 16 8 3 3 3 7 16 16 16 16 1 1 1 1 1 1 1 16 16 1 1 1 1 16 8 3 3 3 7 16 16 16 16 16 16 16 16 16 16 16 8 3 3 3 7 1 1 23
24 16 16 8 3 3 3 7 1 16 16 16 16 1 1 1 2 1 16 16 1 1 1 1 1 16 8 3 3 3 7 16 16 16 16 16 16 16 16 16 16 16 8 3 3 3 7 1 1 23
24 16 16 8 3 3 3 7 1 16 16 16 16 16 1 1 1 1 16 1 1 1 1 1 1 16 8 3 3 3 7 16 16 16 16 16 16 16 16 16 16 16 8 3 3 3 7 1 2 23
24 16 16 8 3 3 3 7 2 1 16 16 16 16 16 1 1 16 16 1 1 1 2 1 1 16 32 17 17 17 32 16 16 16 16 16 16 16 16 16 16 16 8 3 3 3 7 2 1 23
24 16 16 8 3 3 3 7 1 1 1 16 16 16 16 16 16 16 1 1 1 1 1 1 1 16 32 17 36 17 32 16 16 16 16 16 16 16 16 16 16 16 8 3 3 3 7 1 1 23
24 16 16 8 3 3 3 7 1 2 1 1 1 16 16 16 16 16 1 1 2 1 2 1 1 16 32 32 32 32 32 16 16 16 16 16 16 16 16 16 16 16 8 3 3 3 7 1 1 23
24 16 16 8 3 3 3 7 1 1 1 1 1 16 16 16 16 1 2 1 1 1 1 1 1 16 16 16 16 16 16 16 16 16 16 1 1 16 16 16 16 16 8 3 3 3 7 1 2 23
24 16 16 8 3 3 3 7 1 1 1 1 16 16 16 16 16 1 1 1 1 1 1 1 1 1 1 1 1 16 16 16 16 16 1 1 1 1 16 16 16 16 8 3 3 3 7 1 1 23
24 16 16 8 3 3 3 7 1 2 1 16 16 16 16 16 16 1 1 1 2 1 2 1 1 1 1 2 1 16 16 16 16 16 1 1 1 1 1 16 16 16 8 3 3 3 7 1 1 23
24 16 16 8 3 3 3 7 1 1 1 16 16 16 16 16 16 1 2 1 1 1 1 1 1 1 2 1 1 16 16 16 16 1 1 1 1 1 1 16 16 16 8 3 3 3 7 1 1 23
24 16 16 8 3 3 3 7 2 1 16 16 16 16 16 16 16 1 1 1 12 10 10 10 13 1 1 1 1 16 16 16 1 1 1 2 1 1 2 1 16 16 8 3 3 3 7 1 1 23
24 16 16 8 3 3 3 7 1 16 16 16 16 16 16 16 16 1 1 1 8 3 3 3 7 1 1 1 1 16 16 1 1 2 1 1 1 1 1 1 16 16 8 3 3 3 7 1 1 23
24 16 16 8 3 3 3 7 1 16 16 16 16 16 16 16 16 16 1 1 8 3 3 3 7 1 2 1 1 16 1 1 1 1 1 2 1 1 1 1 1 16 8 3 3 3 7 1 1 23
24 16 16 8 3 3 3 7 16 16 16 16 16 16 16 16 16 16 16 1 8 3 3 3 7 1 1 1 16 16 1 1 1 2 1 1 1 2 2 1 1 16 8 3 3 3 7 2 2 23
24 16 16 8 3 3 3 7 16 16 16 16 16 16 16 16 16 16 16 16 8 3 3 3 7 16 16 16 16 16 1 1 1 1 1 1 1 1 1 1 1 16 8 3 3 3 7 1 1 23
24 16 16 8 3 3 3 9 10 10 10 10 10 10 10 10 10 10 10 10 11 3 3 3 9 10 10 10 10 10 10 10 10 10 10 10 10 10 10 10 10 10 11 3 3 3 7 1 1 23
24 16 16 8 3 3 3 3 3 3 3 3 3 3 3 3 3 3 3 3 3 3 3 3 3 3 3 3 3 3 3 3 3 3 3 3 3 3 3 3 3 3 3 3 3 3 7 1 1 23
24 16 16 8 3 3 3 3 3 3 3 3 3 3 3 3 3 3 3 3 3 3 3 3 3 3 3 3 3 3 3 3 3 3 3 3 3 3 3 3 3 3 3 3 3 3 7 2 1 23
24 16 16 8 3 3 3 3 3 3 3 3 3 3 3 3 3 3 3 3 3 3 3 3 3 3 3 3 3 3 3 3 3 3 3 3 3 3 3 3 3 3 3 3 3 3 7 1 1 23
24 16 16 14 5 5 5 5 5 5 5 5 5 5 5 5 5 5 5 5 5 5 5 5 5 5 5 5 5 5 5 5 5 5 5 5 5 5 5 5 5 5 5 5 5 5 15 1 1 23
24 16 16 16 16 16 16 16 16 16 16 16 16 16 16 16 16 16 16 16 16 16 16 16 16 16 16 16 16 16 1 1 1 1 1 1 1 1 1 1 1 2 1 1 1 1 2 1 1 23
24 16 16 16 16 16 16 16 16 16 16 16 16 16 16 16 16 16 16 16 16 16 16 16 16 16 16 16 16 16 16 16 16 16 16 16 16 16 16 16 16 16 16 16 16 16 16 16 16 23
30 21 21 21 21 21 21 21 21 21 21 21 21 21 21 21 21 21 21 21 21 21 21 21 21 21 21 21 21 21 21 21 21 21 21 21 21 21 21 21 21 21 21 21 21 21 21 21 21 31