28 26 26 26 26 26 26 26 26 26 26 26 26 26 26 26 26 26 26 26 26 26 26 26 26 26 26 26 26 26 26 26 26 26 26 26 26 26 26 26 26 26 26 26 26 26 26 26 26 29
24 16 16 16 16 16 16 16 16 16 16 16 16 16 16 16 16 16 16 16 16 16 16 16 16 16 16 16 16 16 16 16 16 16 16 16 16 16 16 16 16 16 1 1 1 2 1 1 1 23
24 16 32 32 32 1 12 10 10 10 10 10 10 10 10 10 10 10 10 10 10 10 10 10 10 10 10 10 10 10 10 10 10 10 10 10 10 10 10 10 10 10 10 10 10 10 10 13 2 23
24 16 32 36 17 2 8 3 3 3 3 3 3 3 3 3 3 3 3 3 3 3 3 3 3 3 3 3 3 3 3 3 3 3 3 3 3 3 3 3 3 3 3 3 3 3 3 7 1 23
24 16 32 17 17 1 8 3 3 3 3 3 3 3 3 3 3 3 3 3 3 3 3 3 3 3 3 3 3 3 3 3 3 3 3 3 3 3 3 3 3 3 3 3 3 3 3 7 2 23
24 16 1 1 2 2 14 5 5 5 5 5 5 5 5 5 5 5 5 5 5 5 5 6 3 3 4 5 5 5 5 5 5 5 5 5 5 5 5 5 5 5 5 5 6 3 3 7 1 23
24 16 12 10 10 13 2 1 1 1 16 16 16 16 16 16 16 16 16 1 1 1 1 8 3 3 7 1 1 1 1 1 16 16 16 16 16 16 16 1 1 1 1 1 8 3 3 7 1 23
24 16 8 3 3 7 1 20 21 21 21 21 21 21 21 21 21 21 21 21 21 22 2 8 3 3 7 1 20 21 21 21 21 21 21 21 21 21 21 21 21 21 22 1 8 3 3 7 1 23
24 16 8 3 3 7 1 23 18 18 18 18 18 18 18 18 18 18 18 18 18 24 2 8 3 3 7 1 23 18 18 18 18 18 18 18 18 18 18 18 18 18 24 1 8 3 3 7 2 23
24 16 8 3 3 7 1 23 18 19 18 18 18 18 18 18 18 18 19 18 18 24 1 8 3 3 7 1 23 18 18 18 18 18 18 18 18 18 18 18 19 18 24 1 8 3 3 7 1 23
24 16 8 3 3 7 16 23 18 18 18 18 18 18 18 18 18 18 18 18 18 24 1 8 3 3 7 1 23 18 18 19 18 18 19 18 18 19 18 18 18 18 24 16 8 3 3 7 1 23
24 16 8 3 3 7 16 23 18 18 18 18 18 18 18 18 18 18 18 18 18 24 1 8 3 3 7 1 23 18 18 18 18 18 18 18 18 18 18 18 18 18 24 16 8 3 3 7 1 23
24 16 8 3 3 7 16 23 18 18 19 19 19 18 18 18 19 18 18 18 18 24 1 8 3 3 7 1 23 18 18 18 18 18 18 18 19 18 18 18 19 18 24 16 8 3 3 7 1 23
24 16 8 3 3 7 16 23 18 18 18 18 18 18 18 18 18 18 18 18 18 24 1 8 3 3 7 1 23 18 18 18 18 18 18 18 18 18 18 18 18 18 24 16 8 3 3 7 1 23
24 16 8 3 3 7 16 23 18 18 18 18 18 18 19 18 18 18 18 18 18 24 1 8 3 3 7 1 23 18 18 18 18 18 19 18 18 18 18 18 18 18 24 16 8 3 3 7 2 23
24 16 8 3 3 7 16 23 18 18 18 18 18 18 18 18 18 18 18 18 18 24 2 8 3 3 7 1 23 18 18 18 18 18 18 18 19 18 18 18 18 18 24 16 8 3 3 7 1 23
24 16 8 3 3 7 16 23 18 19 18 18 18 18 18 18 18 18 18 18 18 24 1 8 3 3 7 1 23 18 18 18 18 18 18 18 18 19 18 18 19 18 24 16 8 3 3 7 1 23
24 16 8 3 3 7 16 23 18 18 18 18 18 18 18 19 18 18 18 18 18 24 1 8 3 3 7 1 23 18 18 18 19 18 18 18 18 18 18 18 18 18 24 16 8 3 3 7 1 23
24 16 8 3 3 7 16 23 18 18 18 18 18 18 18 18 18 18 18 18 18 24 1 8 3 3 7 1 23 18 18 18 18 18 18 18 18 18 18 18 18 18 24 16 8 3 3 7 1 23
24 16 8 3 3 7 1 23 18 18 18 19 18 18 19 18 18 18 18 18 18 24 1 8 3 3 7 1 23 18 19 18 18 18 18 18 18 18 18 18 19 18 24 16 8 3 3 7 1 23
24 16 8 3 3 7 1 23 18 18 18 18 18 18 18 18 18 18 18 18 18 24 1 8 3 3 7 1 23 18 18 18 18 18 18 18 18 18 18 18 18 18 24 16 8 3 3 7 2 23
24 16 8 3 3 7 2 25 26 26 26 26 26 26 26 26 26 26 26 26 26 27 1 8 3 3 7 1 25 26 26 26 26 26 26 26 26 26 26 26 26 26 27 1 8 3 3 7 1 23
24 16 8 3 3 7 1 2 1 1 1 1 16 16 16 16 16 16 16 16 16 1 2 8 3 3 7 1 1 1 16 16 16 16 16 16 16 16 16 16 16 1 1 1 8 3 3 7 1 23
24 16 8 3 3 9 10 10 10 10 10 10 10 10 10 10 10 10 10 10 10 10 10 11 3 3 9 10 10 10 10 10 10 10 10 10 10 10 10 10 10 10 10 10 11 3 3 7 1 23
24 16 8 3 3 3 3 3 3 3 3 3 3 3 3 3 3 3 3 3 3 3 3 3 3 3 3 3 3 3 3 3 3 3 3 3 3 3 3 3 3 3 3 3 3 3 3 7 1 23
24 16 8 3 3 3 3 3 3 3 3 3 3 3 3 3 3 3 3 3 3 3 3 3 3 3 3 3 3 3 3 3 3 3 3 3 3 3 3 3 3 3 3 3 3 3 3 7 1 23
24 16 8 3 3 4 5 5 5 5 5 5 5 5 5 5 5 5 5 5 5 5 5 6 3 3 4 5 5 5 5 5 5 5 5 5 5 5 5 5 5 5 5 5 6 3 3 7 1 23
24 16 8 3 3 7 1 1 1 16 16 16 16 16 16 16 16 16 16 16 1 1 1 8 3 3 7 1 1 1 2 1 16 16 16 16 16 16 16 16 1 1 2 1 8 3 3 7 1 23
24 16 8 3 3 7 1 20 21 21 21 21 21 21 21 21 21 21 21 21 21 22 2 8 3 3 7 2 20 21 21 21 21 21 21 21 21 21 21 21 21 21 22 1 8 3 3 7 1 23
24 16 8 3 3 7 2 23 18 18 18 18 18 18 19 18 18 18 18 18 19 24 1 8 3 3 7 1 23 18 18 18 18 18 18 18 18 18 18 18 18 18 24 1 8 3 3 7 1 23
24 16 8 3 3 7 1 23 18 18 18 18 18 18 18 18 18 18 18 18 18 24 1 8 3 3 7 1 23 18 18 18 18 18 18 18 19 18 18 18 18 18 24 1 8 3 3 7 1 23
24 16 8 3 3 7 16 23 18 18 19 18 18 18 19 18 18 18 18 18 18 24 1 8 3 3 7 16 23 18 18 18 18 18 18 18 18 18 18 19 18 18 24 2 8 3 3 7 1 23
24 16 8 3 3 7 16 23 18 18 18 18 18 18 18 18 18 18 18 18 18 24 2 8 3 3 7 16 23 18 19 18 18 18 19 18 18 18 18 18 18 18 24 1 8 3 3 7 1 23
24 16 8 3 3 7 16 23 18 18 18 18 18 18 18 18 18 18 19 18 18 24 1 8 3 3 7 16 23 18 18 18 18 18 18 18 18 18 18 18 18 18 24 1 8 3 3 7 1 23
24 16 8 3 3 7 16 23 18 18 19 18 18 18 19 18 18 18 18 18 19 24 1 8 3 3 7 16 23 18 18 18 18 18 18 18 18 18 19 18 18 18 24 1 8 3 3 7 2 23
24 16 8 3 3 7 16 23 18 18 18 18 18 18 18 18 18 18 18 18 18 24 1 8 3 3 7 16 23 18 18 18 19 18 18 18 18 18 18 19 18 18 24 1 8 3 3 7 1 23
24 16 8 3 3 7 16 23 18 18 18 18 18 18 18 18 18 18 18 18 18 24 1 8 3 3 7 16 23 18 18 18 18 18 18 18 18 18 18 18 18 18 24 1 8 3 3 7 1 23
24 16 8 3 3 7 16 23 18 18 18 18 18 18 19 18 18 18 18 19 18 24 1 8 3 3 7 16 23 18 19 18 18 18 18 18 18 18 18 18 18 18 24 1 8 3 3 7 1 23
24 16 8 3 3 7 16 23 18 18 19 18 18 18 18 18 18 18 18 18 18 24 1 8 3 3 7 16 23 18 18 18 18 18 18 18 19 18 18 18 19 18 24 1 8 3 3 7 1 23
24 16 8 3 3 7 1 23 18 18 18 18 18 19 18 18 18 19 18 18 18 24 1 8 3 3 7 16 23 18 18 18 18 18 18 18 18 18 18 18 18 18 24 2 8 3 3 7 1 23
24 16 8 3 3 7 1 23 18 18 19 18 18 18 18 18 18 18 18 18 18 24 2 8 3 3 7 16 23 19 18 18 18 19 18 18 18 18 19 18 18 18 24 1 8 3 3 7 1 23
24 1 8 3 3 7 1 23 18 18 18 18 18 18 18 18 18 18 18 18 18 24 1 8 3 3 7 16 23 18 18 18 18 18 18 18 18 18 18 18 18 18 24 2 14 5 5 15 1 23
24 1 8 3 3 7 1 25 26 26 26 26 26 26 26 26 26 26 26 26 26 27 1 8 3 3 7 16 25 26 26 26 26 26 26 26 26 26 26 26 26 26 27 1 2 1 1 1 1 23
24 1 8 3 3 7 2 1 1 1 2 16 16 16 16 16 16 16 1 1 1 2 1 8 3 3 7 16 1 1 1 1 16 16 16 16 16 16 16 16 1 1 1 1 1 1 32 32 2 23
24 1 8 3 3 9 10 10 10 10 10 10 10 10 10 10 10 10 10 10 10 10 10 11 3 3 9 10 10 10 10 10 10 10 10 10 10 10 10 10 10 13 1 2 17 17 17 32 2 23
24 1 8 3 3 3 3 3 3 3 3 3 3 3 3 3 3 3 3 3 3 3 3 3 3 3 3 3 3 3 3 3 3 3 3 3 3 3 3 3 3 7 1 1 17 17 17 32 1 23
24 2 8 3 3 3 3 3 3 3 3 3 3 3 3 3 3 3 3 3 3 3 3 3 3 3 3 3 3 3 3 3 3 3 3 3 3 3 3 3 3 7 1 32 17 17 36 32 1 23
24 1 14 5 5 5 5 5 5 5 5 5 5 5 5 5 5 5 5 5 5 5 5 5 5 5 5 5 5 5 5 5 5 5 5 5 5 5 5 5 5 15 1 32 32 32 32 32 2 23
24 1 2 1 1 1 1 1 1 1 1 1 1 1 1 1 2 1 1 1 1 1 1 2 1 1 2 1 1 1 2 1 2 1 1 1 1 1 1 2 1 1 1 1 1 1 2 1 1 23
30 21 21 21 21 21 21 21 21 21 21 21 21 21 21 21 21 21 21 21 21 21 21 21 21 21 21 21 21 21 21 21 21 21 21 21 21 21 21 21 21 21 21 21 21 21 21 21 21 31