18 18 18 18 18 18 18 18 18 28 26 26 26 26 26 26 26 26 26 26 26 26 26 26 26 26 26 26 26 26 26 26 26 26 26 26 26 26 26 26 26 26 26 26 26 26 26 26 26 29
19 18 18 18 18 18 18 18 18 24 34 1 1 12 10 10 10 13 1 34 16 1 1 2 1 1 1 1 1 2 1 1 2 2 1 1 16 16 12 10 10 10 10 10 10 10 10 10 13 23
19 18 18 18 18 18 18 18 18 24 34 1 1 8 3 3 3 7 1 34 16 2 1 1 1 1 2 1 1 1 2 1 1 1 1 2 1 16 8 3 3 3 3 3 3 3 3 3 7 23
19 18 19 18 19 18 18 18 18 24 34 1 1 8 3 3 3 7 1 34 16 1 12 10 10 10 10 10 10 10 10 10 10 10 10 10 13 16 8 3 4 5 5 5 5 5 6 3 7 23
19 18 18 18 18 18 19 18 18 24 34 1 1 8 3 3 3 7 1 34 16 1 8 3 3 3 3 3 3 3 3 3 3 3 3 3 7 16 8 3 7 16 32 32 32 16 8 3 7 23
19 18 19 18 18 18 18 18 18 24 34 1 1 8 3 3 3 7 1 34 16 2 8 3 3 3 3 3 3 3 3 3 3 3 3 3 7 16 8 3 7 16 32 36 32 16 8 3 7 23
19 18 18 18 18 18 19 18 18 24 34 1 1 8 3 3 3 7 1 34 16 2 8 3 3 3 3 3 3 3 3 3 3 3 3 3 7 16 8 3 7 16 32 17 32 16 8 3 7 23
19 18 19 18 18 18 18 18 18 24 34 1 1 8 3 3 3 7 1 34 16 1 14 5 5 5 5 5 5 5 5 5 6 3 3 3 7 16 8 3 7 16 8 3 7 16 8 3 7 23
19 18 18 18 18 18 18 19 18 24 34 1 2 8 3 3 3 7 2 34 16 2 1 1 1 2 1 1 1 1 1 2 8 3 3 3 7 16 8 3 7 16 8 3 7 16 8 3 7 23
19 19 19 19 19 19 18 18 18 24 34 34 34 8 3 3 3 7 34 34 16 1 1 2 1 1 1 1 2 1 1 1 8 3 3 3 7 16 8 3 7 16 8 3 7 16 8 3 7 23
28 26 26 26 29 19 19 18 18 30 21 21 22 8 3 3 3 7 2 16 16 16 16 16 16 16 16 16 16 16 16 2 8 3 3 3 7 16 8 3 7 16 8 3 7 16 8 3 7 23
24 16 16 16 23 19 18 18 18 18 18 18 24 8 3 3 3 7 2 16 16 16 16 16 16 16 16 16 16 16 16 1 8 3 3 3 7 16 8 3 7 16 8 3 7 16 8 3 7 23
24 16 16 16 23 19 18 18 18 18 18 18 24 8 3 3 3 9 10 10 10 10 10 10 10 10 10 10 10 10 10 10 11 3 3 3 7 16 8 3 7 16 8 3 7 16 8 3 7 23
24 16 16 16 23 19 19 19 19 19 19 18 24 8 3 3 3 3 3 3 3 3 3 3 3 3 3 3 3 3 3 3 3 3 3 3 7 16 8 3 7 16 8 3 7 16 8 3 7 23
24 16 16 16 25 26 26 26 26 29 19 19 24 8 3 3 3 3 3 3 3 3 3 3 3 3 3 3 3 3 3 3 3 3 3 3 7 16 8 3 7 16 8 3 7 16 8 3 7 23
24 16 16 16 16 16 16 16 16 23 19 19 24 8 3 3 3 3 3 3 3 3 3 3 3 3 3 3 3 3 3 3 3 3 3 3 7 16 8 3 7 16 8 3 7 16 8 3 7 23
24 32 32 32 32 32 16 16 16 23 19 19 24 14 5 5 5 5 5 5 5 5 5 5 5 5 5 5 5 5 5 5 6 3 3 3 7 16 8 3 7 16 8 3 7 16 8 3 7 23
24 32 17 36 17 32 16 16 16 23 19 19 24 16 16 16 16 16 16 16 16 16 16 16 16 16 16 16 16 16 16 16 8 3 3 3 7 16 8 3 7 16 8 3 7 16 8 3 7 23
24 32 17 17 17 32 16 16 16 23 19 19 24 16 16 16 16 16 16 16 16 16 16 16 16 16 16 16 16 16 2 1 8 3 3 3 7 16 8 3 7 16 8 3 7 16 8 3 7 23
24 32 17 17 17 32 16 16 16 23 19 19 24 16 16 16 16 16 16 16 16 16 16 16 16 16 16 16 16 1 1 1 8 3 3 3 7 16 8 3 7 16 8 3 7 16 8 3 7 23
24 32 17 17 17 32 16 16 16 23 19 19 30 21 21 22 1 16 16 16 16 16 16 16 16 16 16 16 16 1 2 1 8 3 3 3 7 16 8 3 7 16 8 3 7 16 8 3 7 23
24 8 3 3 3 7 16 16 16 23 19 19 19 19 19 24 1 16 16 16 16 16 16 16 16 16 16 16 1 1 1 1 8 3 3 3 7 16 8 3 7 16 8 3 7 16 8 3 7 23
24 8 3 3 3 7 16 16 16 23 19 19 19 19 19 24 1 16 16 16 16 16 16 16 16 16 16 16 1 1 1 1 8 3 3 3 7 16 8 3 7 16 8 3 7 16 8 3 7 23
24 8 3 3 3 7 16 16 16 25 26 26 26 29 19 24 1 16 16 16 16 16 16 16 16 16 16 1 1 1 1 1 8 3 3 3 7 16 8 3 9 10 11 3 7 16 8 3 7 23
24 8 3 3 3 7 1 1 2 1 2 2 2 23 19 24 1 16 16 16 16 16 16 16 16 16 16 1 2 1 1 2 8 3 3 3 7 16 8 3 3 3 3 3 7 16 8 3 7 23
24 8 3 3 3 9 10 10 10 10 10 13 1 23 19 24 1 16 16 16 16 16 16 16 16 16 16 1 1 1 1 2 8 3 3 3 7 16 14 5 5 5 5 5 15 16 8 3 7 23
24 8 3 3 3 3 3 3 3 3 3 7 2 23 19 24 1 16 16 16 16 16 16 16 16 16 16 1 1 1 1 1 8 3 3 3 7 16 16 16 16 16 16 16 16 16 8 3 7 23
24 8 3 3 3 4 5 5 5 5 5 15 1 23 19 24 1 16 16 16 16 16 16 16 16 16 16 2 2 1 2 1 8 3 3 3 9 10 10 10 10 10 10 10 10 10 11 3 7 23
24 8 3 3 3 7 1 1 2 1 1 2 1 23 19 24 1 1 1 1 1 1 1 1 1 16 16 1 1 1 1 1 8 3 3 3 3 3 3 3 3 3 3 3 3 3 3 3 7 23
24 8 3 3 3 7 16 20 21 21 21 21 21 31 19 30 21 21 21 21 21 21 21 21 22 16 16 1 1 1 2 1 8 3 3 3 3 3 3 3 3 3 3 3 3 3 3 3 7 23
24 8 3 3 3 7 16 23 18 18 18 18 18 18 18 18 18 18 18 18 18 18 18 18 24 16 16 16 1 1 1 1 8 3 3 3 3 3 3 3 3 3 3 3 3 3 3 3 7 23
24 8 3 3 3 7 16 23 18 18 18 18 18 18 18 18 18 18 18 18 18 18 18 18 24 16 16 16 1 2 1 1 8 3 3 3 4 5 5 5 5 5 5 6 3 4 5 5 15 23
24 8 3 3 3 7 16 23 18 18 18 18 18 18 18 18 18 18 18 18 18 18 18 18 24 16 16 16 16 1 1 2 8 3 3 3 7 16 16 16 16 16 16 8 3 7 16 16 16 23
24 8 3 3 3 7 16 23 18 18 18 18 18 18 18 18 18 18 18 18 18 18 18 18 24 16 16 16 16 16 1 1 8 3 3 3 7 16 16 16 16 16 16 8 3 7 16 16 16 23
24 8 3 3 3 7 16 23 18 18 18 18 18 18 18 18 18 18 18 18 18 18 18 18 24 16 16 16 16 16 16 16 8 3 3 3 7 16 16 32 32 32 16 8 3 7 16 16 16 23
24 8 3 3 3 7 16 23 18 18 18 18 18 18 18 18 18 18 18 18 18 18 18 18 24 16 16 16 16 16 16 16 8 3 3 3 7 16 16 32 36 32 16 8 3 7 16 16 16 23
24 8 3 3 3 7 16 23 18 18 18 18 18 18 18 18 18 18 18 18 18 18 18 18 24 16 16 16 16 16 16 16 8 3 3 3 7 16 16 32 17 32 16 8 3 7 16 16 16 23
24 8 3 3 3 7 16 23 18 18 18 18 18 18 18 18 18 18 18 18 18 18 18 18 24 16 16 16 16 16 16 16 8 3 3 3 7 16 16 8 3 7 16 8 3 7 16 16 16 23
24 8 3 3 3 7 16 23 18 18 18 18 18 18 18 18 18 18 18 18 18 18 18 18 24 16 16 16 16 16 16 16 8 3 3 3 7 16 16 8 3 7 16 8 3 7 16 16 16 23
24 8 3 3 3 7 16 23 18 18 18 18 18 18 18 18 18 18 18 18 18 18 18 18 24 16 16 16 16 16 16 16 8 3 3 3 7 16 16 8 3 7 16 8 3 7 16 16 16 23
24 8 3 3 3 7 16 25 26 26 26 26 26 26 26 26 26 26 26 26 26 26 26 26 27 16 16 16 16 16 16 16 8 3 3 3 7 16 16 8 3 7 16 8 3 7 16 16 16 23
24 8 3 3 3 7 16 16 16 16 16 16 16 16 16 16 16 16 16 16 16 16 16 16 16 16 16 16 16 16 16 16 8 3 3 3 7 16 16 8 3 7 16 8 3 7 16 16 16 23
24 8 3 3 3 7 2 1 2 2 1 1 2 1 1 2 1 1 2 1 1 1 1 2 2 1 2 1 1 2 1 1 8 3 3 3 7 16 16 8 3 7 16 8 3 7 16 16 16 23
24 8 3 3 3 9 10 10 10 10 10 10 10 10 10 10 10 10 10 10 10 10 10 10 10 10 10 10 10 10 10 10 11 3 3 3 7 16 16 8 3 7 16 8 3 7 16 16 16 23
24 8 3 3 3 3 3 3 3 3 3 3 3 3 3 3 3 3 3 3 3 3 3 3 3 3 3 3 3 3 3 3 3 3 3 3 7 16 16 8 3 9 10 11 3 7 16 16 16 23
24 8 3 3 3 3 3 3 3 3 3 3 3 3 3 3 3 3 3 3 3 3 3 3 3 3 3 3 3 3 3 3 3 3 3 3 7 16 16 8 3 3 3 3 3 7 16 16 16 23
24 8 3 3 3 3 3 3 3 3 3 3 3 3 3 3 3 3 3 3 3 3 3 3 3 3 3 3 3 3 3 3 3 3 3 3 7 16 16 14 5 5 5 5 5 15 16 16 16 23
24 8 3 3 3 3 3 3 3 3 3 3 3 3 3 3 3 3 3 3 3 3 3 3 3 3 3 3 3 3 3 3 3 3 3 3 7 16 16 16 16 16 16 16 16 16 16 16 16 23
24 14 5 5 5 5 5 5 5 5 5 5 5 5 5 5 5 5 5 5 5 5 5 5 5 5 5 5 5 5 5 5 5 5 5 5 15 16 16 16 16 16 16 16 16 16 16 16 16 23
30 21 21 21 21 21 21 21 21 21 21 21 21 21 21 21 21 21 21 21 21 21 21 21 21 21 21 21 21 21 21 21 21 21 21 21 21 21 21 21 21 21 21 21 21 21 21 21 21 31